	111	211	112	214	444	666	888
	1	1	2	2	.2	.2	.2
a	.1	.5	.1	.5	.2	.2	.2
b	.1	.7	.1	.7	.2	.2	.2
c	.1	.1	.1	.1	.2	.2	.2
d	.1	.1	.1	.1	.2	.2	.2
A	.1	.1	.1	.1	.2	.2	.2
B	.1	.8	.8	.1	.2	.2	.2
C	.1	.1	.1	.1	.2	.2	.2
D	.1	.1	.1	.1	.2	.2	.2
E	.1	.1	.1	.1	.2	.2	.2
F	.1	.1	.1	.1	.2	.2	.2
G	.1	.1	.1	.1	.2	.2	.2
H	.1	.1	.1	.1	.2	.2	.2
